#######
#.#.#.#
#.....#
###.###
#.....#
#.#.#.#
#######