#######
#.#...#
#.#.#.#
#.#.#.#
#.#.#.#
#...#.#
#######